111111111111111111
1P1C00000000000001
101111000000000001
100100000000000001
100000000000000001
111110111111111101
1C000001E000000001
111111111111111111