111111111111111111111111111111
1000000000000000000000000000E1
101010011111111111111111111111
101111110000000000C10001000101
100000000000000000010101010101
111111110000000000010101010101
100000C10000000000000100010001
101111111111011111111111111101
100000010001010001C00000000001
111111010101010101111111111111
100001010101000100000000000001
100101010101111111111111111101
10P100000100000000000000000001
111111111111111111111111111111